||||||||
|XX0000|
|XXDX0X|
|XX0X0X|
|XXXX0X|
|000000|
|0XXXX0|
|0XXXXP|
|00XXX0|
|X00GX0|
||||||||