XXXXXXXXXXX
XP     *  X
X         X
X         X
X  *      X
X        GX
X         X
X         X
X    *    X
XXXXXXXXXXX