+------------------------+
|P     |       |         |
| +-+  | +--+  |  +---+  |
| | |  |    |  |      |  |
| + |  |--+ |  +---+  |  |
|   |  |    |         |  |
|---+  +  +-----------+  |
|   |         *          |
| + +-----+  +--------+  |
| |         *         |  |
| +-----------------+ |  |
|  |         *        |  |
|  |     +  +  +  +---+  |
|  +--+  |  |  |  |      |
|     |  |  |  |  |  +---|
|--+  +  |  |  |  +      |
|    *   |  |  |      +  |
|  +--------+  |  +   |  |
|  |T          |  |   |  |
+------------------------+